10,10,
..^.#.^...
.<..#...^.
....#.....
..........
.#.v#.#.##
....###v..
##.##..##.
.<.>#..<!.
@.#v#>.##.
....>.....